0 0 0 0 1 1 1 1 1 1 0 0 0 0 0
0 0 0 0 1 0 1 0 0 1 0 0 0 0 0
0 0 0 0 1 4 0 4 0 1 0 0 0 0 0
0 0 1 1 1 0 1 3 0 1 1 1 1 1 1
0 0 1 0 4 3 0 0 0 3 0 1 0 0 1
1 1 1 0 3 4 3 4 0 4 3 0 0 0 1
1 4 0 0 3 2 4 3 4 1 1 4 0 0 1
1 1 3 1 0 3 1 1 0 0 1 0 3 1 1
0 1 0 0 1 0 0 1 1 0 1 1 0 1 0
0 1 1 0 0 0 4 1 0 3 0 0 4 1 0
0 0 1 1 1 0 0 0 0 0 0 1 0 1 0
0 0 0 0 1 1 1 1 1 1 1 1 1 1 0
